NO xpm/stone_wall.xpm
SO xpm/stone_wall.xpm
WE xpm/stone_wall.xpm
EA xpm/stone_wall.xpm

F 250,100,0
C 111,176,234

111111
100001
100001
100011
100001
100001
10000111111111111111111111
10000000000000000000000011
10000000011110W00000010011
10000000000001111100000111
11111111111111111111111111
