NO xpm/stone_wall.xpm
SO xpm/stone_wall.xpm
WE xpm/stone_wall.xpm
EA xpm/stone_wall.xpm

F 250,100,100
C 111,176,234

11111


111111
100001
100001
100011
100001
100001
10000111111111111111111111
10000000000000000000000011
100000000111100000000W0011
10000000000001111100000111
11111111111111111111111111
