NO SRCS/XPM/stone_wall.xpm
SO SRCS/XPM/stone_wall.xpm
WE SRCS/XPM/stone_wall.xpm
EA SRCS/XPM/stone_wall.xpm

F 250,100,234
C 111,176,189

111111
100001
100001
100011
100001
100001
10000111111111111111111111
1000000000000000000000011
10001000011110000000000011
10000000000001111100000111
1111111111111111111111111

