NO SRCS/XPM/stone_wall.xpm
SO SRCS/XPM/redbrick.xpm
WE SRCS/XPM/greystone.xpm
EA SRCS/XPM/wood.xpm

F 250,100,234
C 111,176,189

111111
100001
100001
100011
100001
100001   1111
100001111111N1111111111111
1000000000000000000000011
10000000111100000000000111
10000000000001111100000111
1111111111111111111111111